11111111111111111111111111111
1E11100000CCC0011111000001101
10011011100000000111111100C01
1C0110111111CCC10011111000111
10C110110011CCC11001110011111
1C0110CC0111CCC11100110000111
1000CCCC1111CCC11110000000001
11111111111111111111111110001
10P0000C001111CC00000C000C001
10001100000111111000111110001
1000110CC001110C111110C00C001
10CCC11000001100CC0000C00CC01
100100110C10010100110C0111111
100CC101100100010C00000110001
10011000110C100110C0111100C01
100110C001100C110000111000001
1000C00C00000C11100001100CC01
10C0011110C0C0111CC0C000C1111
11111111111111111111111111111
