11111111111111111111111111111111111111111111111111111111111
1P000000000000011100000000000000000011100000000000000000001
10101111100111111101111111111100110011101111111111111111111
10101000000111000001110000000000110011000000000001110000001
10101100001110000011110000000001110011100000000011100111101
10101100001110000001110111011110000011101110000000000111101
10101000000111000001110111001100000111101110000001111110001
10101001100111100001110111000000111000001110111100111110111
10101001100110000001110111000000110000001110111000000000011
10111001100110011111110111111111111111111110111001111110011
10000001100000011100000000000000000000000000111001100000001
10011111111111111101110111111111111111111111111001111111011
10000001110000011100000001111111111111111100111000000000001
10000011100000011100000000000000000000000000111100000000001
10101100000110000011110111C11100000111111111111100000111001
10101000001111000001110111001100000011111111111000000110001
11111001111111111101110111001100110011111111111001100111111
10000001100000011101110111000000110011111111111001100111001
10111111100110011111110111111111111111111110111001100110011
10001000000110001111100111111111111111111110111001100000011
10101000001111000000000111000000000000001110111011110000011
10101000000000011111100111001100111000001110000000001110011
10101000000000011100000111001100110000001110000000000110011
10111111100111111001110111001100110011111111111111100111111
10000001100110000001110111000000111000001110000000000110001
10111111100110011111110111001111111111101110111111111110011
10101000000110011100000111001100000000001110000011100000011
10101001100110111100111111111111111111011111000001110000011
10000001100110011100000000000000111000000000111000000010011
110000111000001111100000000111001100111100011111000011110E1
11111111111111111111111111111111111111111111111111111111111