11111111111111111111111111111
1PCCCCCCCCCCCCCCCCCCCCCCCCCC1
111111111111111111111111111C1
1CCCCCCCCCCCCCCCCCCCCCCCCC1C1
1C11111111111111111111111C1C1
1C1CCCCCCCCCCCCCCCCCCCCC1C1C1
1C1C1111111111111111111C1C1C1
1C1C1CCCCCCCCCCCCCCCCC1C1C1C1
1C1C1C111111111111111C1C1C1C1
1C1C1C10ECCCCCCCCCCCCC1C1C1C1
1C1C1C11111111111111111C1C1C1
1C1C1CCCCCCCCCCCCCCCCCCC1C1C1
1C1C111111111111111111111C1C1
1C1CCCCCCCCCCCCCCCCCCCCCCC1C1
1C1111111111111111111111111C1
1CCCCCCCCCCCCCCCCCCCCCCCCCCC1
11111111111111111111111111111