1111111111111
1C110C00C00C1
100C011011001
1001011C111C1
1P0C00E00C1C1
1111111111111
